#S#E###########
#.#.#.........#
#.#.#.#######.#
#.#.#.......#.#
#.#.#######.#.#
#.#.........#.#
#.###########.#
#.............#
###############
